5 4 4 5 3 4
3 3 3 3 3 4
4 4 4 3 5 4
5 5 5 2 5 5
3 3 3 3 5 5
3 4 3 3 2 3